%%%%%%%%%%%%%%%%%%%%
%......%G   %......%
%.%%...%%  %%...%%.%
%.%o.%........%.o%.%
%.%%.%.%%%%%%.%.%%.%
%........P.........%
%%%%%%%%%%%%%%%%%%%%
