%%%%%%%%%%%%%%%%%%%%
%                G %
%                  %
%%%%%%%%%%%%%%%%%%%%
%                  %
%                  %
%                  %
%%%%%%%%%%%%%%%%%%%%
%......%    %......%
%.%%...%%  %%...%%.%
%.% .%........%. %.%
%.%%.%.%%%%%%.%.%%.%
%........P.........%
%%%%%%%%%%%%%%%%%%%%
