%%%%%%%%%%%%%%%%%%%%
%......%G   %......%
%.%%...%%  %%...%%.%
%.% .%........%. %.%
%.%%.%.%%%%%%.%.%%.%
%........P.........%
%%%%%%%%%%%%%%%%%%%%
