%%%%%%%
%     %
%     %
%     %
%     %
%%%%%%%
% .   %
%. .  %
%     %
%.G.  %
%     %
%%%%% %
%     %
%P .  %
%%%%%%%
